T    C????????????????????????
     C????????????????????????
???  C????????????????????????
???   ????????????????????????
???   ????????????????????????
???C C????????????????????????
???CCC????????????????????????
???CCC????????????????????????
??????????????????????????????
??????????????????????????????
